R 1280 720
NO ./textures/1.xpm
SO ./textures/2.xpm
WE ./textures/3.xpm
EA ./textures/4.png
S ./textures/sprite.xpm
C 0,0,0
F 66,66,66

111111111
10S000001
100000001
111111111